111111111111111111111111111111111111111111111111111111111111111111111111111111111111111111111111111111111111111111111111111111111111111111111111111111111111111111111111111111111111111111111111111111
1ECCCCCCCCCCCCCCCCCCCCCCCCCCCCCCCCCCCCCCCCCCCCCCCCCCCCCCCCCCCCCCCCCCCCCCCCCCCCCCCCCCCCCCCCCCCCCCCCCCCCCCCCCCCCCCCCCCCCCCCCCCCCCCCCCCCCCCCCCCCCCCCCCCCCCCCCCCCCCCCCCCCCCCCCCCCCCCCCCCCCCCCCCCCCCCCCCCC1
1C1CC1C1CC1CCCCC1C1CC1CCCCCCC1C1CCCCCCCCCCCCCCCCCCCCCCCCCCC1CCCCCCCCCC1C1CCCCCCCCCCCCCCCCCCCCCCCCCCCCCCC1C1CC1CCCCC1C1CC1CCCCCCC1C1CCCCCCCCCCCCCCCCCCCCCCCCCCC1CCCCCCCCCC1C1CCCCCCCCCCCCCCCCCCCCCCCCC1
1C1CC1CC1C1C1C1CCC1CC1CCCCCCC1C1CCCCCCCCCCCCCCCCCCCCCCCCCCC1CCCCCCCCCC1C1CCCCCCCCCCCCCCCCCCCCCCCCCCCCCCC1CC1C1C1C1CCC1CC1CCCCCCC1C1CCCCCCCCCCCCCCCCCCCCCCCCCCC1CCCCCCCCCC1C1CCCCCCCCCCCCCCCCCCCCCCCCC1
1PCCCCCCCCCCCCCCCCCCCCCCCCCCCCCCCC1CCCCCCCCCCCCCCCCCCCCCCCCCCCCCCCCCCC1CCCCCCCCCCCCCCCCCCCCCCCCCCCCCCCCCCCCCCCCCCCCCCCCCCCCCCCCCCCCCC1CCCCCCCCCCCCCCCCCCCCCCCCCCCCCCCCCCC1CCCCCCCCCCCCCCCCCCCCCCCCCCC1
111111111111111111111111111111111111111111111111111111111111111111111111111111111111111111111111111111111111111111111111111111111111111111111111111111111111111111111111111111111111111111111111111111
