11111111111111111111111111111111111111111111111111111111111111111111111111111111111111111111111111111111111111111111111111111111111111111111111111111111111111111111111111111111111111111111111111111111111111111111111111111111111111111111111111111111111111111111111111111111111111111111111111111111111
1ECCCCCCCCCCCCCCCCCCCCCCCCCCCCCCCCCCCCCCCCCCCCCCCCCCCCCCCCCCCCCCCCCCCCCCCCCCCCCCCCCCCCCCCCCCCCCCCCCCCCCCCCCCCCCCCCCCCCCCCCCCCCCCCCCCCCCCCCCCCCCCCCCCCCCCCCCCCCCCCCCCCCCCCCCCCCCCCCCCCCCCCCCCCCCCCCCCCCCCCCCCCCCCCCCCCCCCCCCCCCCCCCCCCCCCCCCCCCCCCCCCCCCCCCCCCCCCCCCCCCCCCCCCCCCCCCCCCCCCCCCCCCCCCCCCCCCCCC1
1C1CC1C1CC1CCCCC1C1CC1CCCCCCC1C1CCCCCCCCCCCCCCCCCCCCCCCCCCCCCCCCCCCCCCC1CCCCCCCCCC1C1CCCCCCCCCCCCCCCCCCCCCCCCC1CC1C1CC1CCCCC1C1CC1CCCCCCC1C1CCCCCCCCCCCCCCCCCCCCCCCCC1CCCCCCCCCC1C1CCCCCCCCCCCCCCCCCCCCCC1CC1C1CC1CCCCC1C1CC1CCCCCCC1C1CCCCCCCCCCCCCCCCCCCCCCCCC1CCCCCCCCCC1C1CCCCCCCCCCCCCCCCCCCCCCCCCCCC1
1C1CC1CC1C1C1C1CCC1CC1CCCCCCC1C1CCCCCCCCCCCCCCCCCCCCCCCCCCCCCCCCCCCCCCC1CCCCCCCCCC1C1CCCCCCCCCCCCCCCCCCCCCCCCC1CC1CC1C1C1C1CCC1CC1CCCCCCC1C1CCCCCCCCCCCCCCCCCCCCCCCCC1CCCCCCCCCC1C1CCCCCCCCCCCCCCCCCCCCCC1CC1CC1C1C1C1CCC1CC1CCCCCCC1C1CCCCCCCCCCCCCCCCCCCCCCCCC1CCCCCCCCCC1C1CCCCCCCCCCCCCCCCCCCCCCCCCCCC1
1PCCCCCCCCCCCCCCCCCCCCCCCCCCCCCCCC1CCCCCCCCCCCCCCCCCCCCCCCCCCCCCCCCCCCCCCCCCCCCCCC1CCCCCCCCCCCCCCCCCCCCCCCCCCCCCCCCCCCCCCCCCCCCCCCCCCCCCCCCCCC1CCCCCCCCCCCCCCCCCCCCCCCCCCCCCCCCC1CCCCCCCCCCCCCCCCCCCCCCCCCCCCCCCCCCCCCCCCCCCCCCCCCCCCCCCC1CCCCCCCCCCCCCCCCCCCCCCCCCCCCCCCCC1CCCCCCCCCCCCCCCCCCCCCCCCCCCCCC1
11111111111111111111111111111111111111111111111111111111111111111111111111111111111111111111111111111111111111111111111111111111111111111111111111111111111111111111111111111111111111111111111111111111111111111111111111111111111111111111111111111111111111111111111111111111111111111111111111111111111