111111111111111111111111111111
1P00000001C1000000000000001C11
11000000010100000000E000000011
1100000C0101100000000000001011
110000000000000111111110001011
110010000000000100000010001001
110000000000000100000010001001
1100C00000000001000000100010C1
111111111111111111111111111111