111111111111
1P0000000E11
11P0C0000001
111111111111