111111111111
1P0000000E11
1100C0000E01
111111111111