111111111111
1P0000000011
1100C0000011
111111111111