111111111111
1PP000000CE1
111111111111
