1111111111111111111111111111111
1P00000001C10000000000000001C11
1100000001010000000000000000011
1100000C01011000000000000001011
1100000000000001111111100001011
1100100000000001CCCCCC100001001
1100000000000001000000100001001
1100C00000000001000000100E010C1
1111111111111111111111111111111