1111111111111
1P00010000001
100C0100E0001
1000010000001
1111111111111