1111111111111
1P0001CCCCCC1
100001CCCCCC1
1000E1CCCCCC1
1111111111111