111111111
10T000CE1
1TPT00001
10T000001
111111111