1111111111111
1P001C1CCC1T1
10000CCCCC1C1
10000CCCCC1C1
10000CCCCCCC1
10000CCCCCCC1
10000CCCCCCC1
1C0E1CCCCCCC1
1111111111111