1111111111111
1P00000T00001
1000000000001
1C0E000000001
1111111111111