1111111111111
1P001C1CCCCC1
10000C1C1CCT1
1C0E1CCC1CCC1
1111111111111