1111111111111
1P00000T00001
1000000000001
1C0E00T000001
1111111111111