1111111111111
1P000000011T1
10000001000T1
1C0E0001111T1
1111111111111