11111111111111111111111111111111111
100000000000000000000000000000011T1
100000000000000000000000000001000T1
10000000TTTTTTTTTTTTTTT0000001000T1
10000000T0000000000000T0000001000T1
10000000T0000000000000T0000001000T1
10000000T0000000000000T0000001000T1
10000000T00000000P0000T0000001000T1
10000000T0000000000000T0000001000T1
10000000T0000000000000T0000001000T1
10000000T0000000000000T0000001000T1
10000000T0000000000000T0000001000T1
100000000000000000000000000001000T1
100000000000000000000000000001000T1
100000000000000000000000000001000T1
1C0E00000000000000000000000001111T1
11111111111111111111111111111111111