1111111111
11110000000E1
10P0CCCCC0001
1000001111111
1111111111111