1111111111
11110000000E1
10P0CCCCC1
1000001111111
111111111