111111111
100000001
1P00C00E1
100000001
100000001