011111110
100000001
1P00C00E1
100000001
011111110