011111111
000000001
0P00C00E1
000000001
011111111