011111111
000000001
0P00C00E1
0P00C00E1
011111111