111111110
100000000
1P00C00E0
100000000
111111110