100000001
000000000
0P00C00E0
000000000
100000001