011101001
100000000
1P00C00E1
100000000
101101001