0111C1001
10000000C
1P00C0001
100000000
1C11010E1